g.g.g.g.g.g.g.g.g.g.g.g.g.g.g.g.g.g.g.g.
g.gdg.g.g.g.g.g.g.g.g.grg.g.g.g.g.g.gdg.
g.g.grg.g.g.g.g.g.g.g.g.g.g.g.g.g.g.g.g.
g.g.g.g.g.g.g.g.g.g.g.g.g.g.g.g.grg.g.g.
g.g.g.g.g.g.g.grg.g.g.g.g.g.g.g.g.g.g.g.
g.g.g.g.g.g.g.g.g.g.g.g.g.g.g.g.s.s.s.s.
grg.g.g.g.g.g.g.g.g.g.g.s.s.s.s.s.w.w.w.
g.g.g.g.g.g.s.s.s.s.s.s.s.w.w.w.w.w.w.w.
s.sds.s.s.s.s.s.s.w.w.w.w.w.w.w.w.w.wdw.
s.s.w.w.w.w.w.w.w.w.w.w.w.w.w.w.w.w.w.w.